{
  "id": "level-04",
  "name": "Level 4",
  "exit": {
    "page": 0,
    "x": 28,
    "y": 16
  },
  "pages": [
    {
      "tiles": [
        "WWWWWWWWWWWWWWWWWWWWWWWWWWWWWW",
        "W............................W",
        "W............................W",
        "W............................W",
        "W............................W",
        "W............................W",
        "W............................W",
        "W............................W",
        "W............................W",
        "W............................W",
        "W............................W",
        "W............................W",
        "W............................W",
        "W............................W",
        "W............................W",
        "W............................W",
        "W............................W",
        "WWWWWWWWWWWWWWWWWWWWWWWWWWWWWW"
      ],
      "spawn": {
        "x": 1,
        "y": 16
      }
    }
  ]
}
