{
  "id": "level-01",
  "name": "Level 1",
  "exit": {
    "page": 0,
    "x": 13,
    "y": 6
  },
  "pages": [
    {
      "tiles": [
        ".......WWWWWWWWWWWWW..........",
        ".......W...........W..........",
        ".......W...........W..........",
        ".......W...........W..........",
        ".......W...WWWWW...W..........",
        ".......W...W...W...W..........",
        ".......W...W...W...W..........",
        ".......W...W...W...W..........",
        ".......W...W...W...W..........",
        ".......W...W...W...W..........",
        ".......W.......W...W..........",
        ".......W.......W...W..........",
        ".......W.......W...W..........",
        ".......WWWWWWWWW...W..........",
        ".......W...........W..........",
        ".......W...........W..........",
        ".......W...........W..........",
        ".......WWWWWWWWWWWWW.........."
      ],
      "spawn": {
        "x": 9,
        "y": 16
      },
      "text_labels": [
        {
          "x": 11,
          "y": 15,
          "width": 4,
          "height": 2,
          "text": "Use \"LEFT\", \"RIGHT\",\"UP\",\"DOWN\" key to move"
        }
      ]
    }
  ]
}
