2,,,,2,2,2,2,2,2,2,,,,,6,7
2,,,,,,,,,,,,,,,6,7
2,,,,,,,,,,,,,,,6,7
2,,,,,50,50,50,50,50,,,,,,6,7
2,,,,,,,,,,,,,,,6,7
2,,,,50,50,50,50,50,50,50,,,,,6,7
2,,,,,,,,,,,,,,,6,7
2,,,,50,50,50,50,50,50,50,,,,,6,7
2,,,,2,2,2,2,2,2,2,,,,,6,7
2,,,,2,2,2,2,2,2,2,,,"*pipe-l:SMB1_World01_01_01@168,11",13,39,40
2,,,,2,2,2,2,2,2,2,,,14,15,41,42
1,1,1,1,1,1,1,1,1,1,1,1,1,1,1,1,1
1,1,1,1,1,1,1,1,1,1,1,1,1,1,1,1,1
