{
  "exit": {
    "page": 0.0,
    "x": 14,
    "y": 1
  },
  "id": "100000",
  "name": "Phase 1 Test",
  "pages": [
    {
      "spawn": {
        "x": 12,
        "y": 18
      },
      "teleports": [],
      "tiles": [
        "WWWWWWWWWWWWWWWWWWWWWWWWWW",
        "W.W......................W",
        "W.W......................W",
        "W.W......................W",
        "W.W...WWWWWWWW...........W",
        "W.W.....................WW",
        "W.W.....................W.",
        "W.WWWW...........WWWW...W.",
        "W.......................W.",
        "W.......................W.",
        "W.......................W.",
        "W.......................W.",
        "W..WWW............WWW...W.",
        "W.......................W.",
        "W.......................W.",
        "W.......................W.",
        "W.......................W.",
        "W.......................W.",
        "W.......................W.",
        "WWWWWWWWWWWWWWWWWWWWWWWWW."
      ]
    }
  ]
}